NAME                        	CODE	CAPACITY 
                            	
Africa                      	
Johannesburg, South Africa  	jnb 	313     	
                            	
Asia Pacific                	
Mumbai, India               	bom 	157     	
Singapore, Singapore        	sin 	821     	
Sydney, Australia           	syd 	483     	
Tokyo, Japan                	nrt 	-252    	
                            	
Europe                      	
Amsterdam, Netherlands      	ams 	1446    	
Frankfurt, Germany          	fra 	1272    	
London, United Kingdom      	lhr 	970     	
Paris, France               	cdg 	2152    	
Stockholm, Sweden           	arn 	967     	
                            	
North America               	
Ashburn, Virginia (US)      	iad 	-1310   	
Chicago, Illinois (US)      	ord 	20      	
Dallas, Texas (US)          	dfw 	1067    	
Los Angeles, California (US)	lax 	698     	
San Jose, California (US)   	sjc 	533     	
Secaucus, NJ (US)           	ewr 	-56     	
Toronto, Canada             	yyz 	787     	
                            	
South America               	
Sao Paulo, Brazil           	gru 	1707    	

